11111111111111111111111111111111111
10000000000000000000000000000000001
10000000000000000000000000000000001
10002200000000000000000000000220001
10000000000000000000000000000000001
10000000000000000000000000000000001
10000000000000000000000000000000001
10111111111102222220111111111111101
10000000000000000000000000000000001
10000000000000000000000000000000001
10000000000111111111111000000000001
10000000000100000000001000000000001
10000000000100000000001000000000001
10000000000111111111111000000000001
10000000000000000000000000000000001
10000000000000000000000000000000001
10002200000000000000000000000220001
10000000000000000000000000000000001
10000000000000000000000000000000001
10000000000000000000000000000000001
10000000000000000000000000000000001
11111111111111111111111111111111111
